1111111111111111111
100100C00000C0001C1
100000010C00000C111
1000111010010011001
10100C00000C0000001
100000010C00000C001
10P0111E10010011001
1111111111111111111